11111111111111111111111111111
10000000000000000000000000001
10101010101010101010101010101
1P00100010001000100010C010001
10101010101010101010101010101
1000100010001C001000100010001
10101010101010101010101010101
10001000100010001000100010C01
10101010101010101010101010101
10001000100010001000100010001
10101010101010101010101010101
1000100010C010001000100010001
100000000000000000000000000E1
11111111111111111111111111111
