1111111111111111111111111
1P0000000000010000000C101
1011110110110001111111101
1000010100000100000000101
1111010110111111111100101
10C1010000100000010000101
1011011111101111011111101
1000000000001000010000001
1011111E11111011110111111
1000000000010C00000100001
1011111011111111101111101
100000C1000000000000000C1
1111111111111111111111111