1111111111
1000000001
1000000C01
1000000001
100C00E001
1111111111