1111111111
100000001
10P00000C01
1000000001
100C00E001
1111111111