1111111111
1000000001
100100C001
1P00000001
1111111111