1111111111
1000000001
10P0000C01
1000000001
100C00E000
1111111111