1111111111
1000000001
100100C001
0P00000E01
1111111111