1111111111
1000X00001
10P0000C01
1000000001
1000Z0E001
1111111111