1111111111
1000000001
100100C101
1P00111E11
1111111111