1111111111
1000000001
10P0000001
1011111001
10000C1001
1000001001
100000E001
1111111111