1111111111
1000000001
10P000PC01
1000000001
100000E001
1111111111