1111111111
1000000001
10P0000001
1000000011
1000001C01
1000001101
10000E0001
1111111111