1111111111
1000000001
100100C001
1P0000PE01
1111111111