1111111111
1000100001
1001C11001
1P00100E01
1111111111