111111111
1P0000111
1000E0111
10C000111
111111111
