1111111111111
1000000000001
10C0000000001
1000000000001
1000000000001
1000000000001
1000000000001
1000000000001
1000000000001
1000000000001
1000000000001
1000000000001
10P00000000E1
1111111111111 