1111111111
100C000001
1110111101
1P00000E01
1111111111
